空空空空空空空空空空空空空
草砖空铁空砖空铁空砖空砖空
空砖空铁空砖空砖空砖空铁空
空砖草砖草砖空铁空砖空砖草
空砖空砖空铁草砖空砖空砖空
空砖空水草砖空砖空水空铁草
草砖空砖空水草铁空水空砖草
空砖空水空砖空水空砖空铁空
空砖空砖草砖空砖空砖空砖空
空砖空砖空水草砖空水空砖空
空砖空砖空砖空砖空砖空砖空
空砖空砖空砖空砖空砖空砖空
空空空空空空鸟空空凸空空空